2 0 3 1 4 2 0 3 1 4
1 4 2 0 3 1 4 2 0 3
0 3 1 4 2 0 3 1 4 2
4 2 0 3 1 4 2 0 3 1
3 1 4 2 0 3 1 4 2 0
2 0 3 1 4 2 0 3 1 4
1 4 2 7 3 1 4 2 0 3
0 3 1 4 2 0 3 7 4 2
4 2 5 3 1 4 2 0 3 1
3 1 4 7 5 3 6 4 2 5